⠀⠀⠀⢀⣠⣤⣤⣤⣀⡀⠀⠀⠀⠀⠀⠀⠀⠀⠀⠀⢀⣀⣤⣤⣤⣄⡀⠀⠀⠀
⠀⠀⣼⠋⠁⠀⠀⠀⣉⣿⣷⣶⣿⣿⣿⣿⣿⣿⣶⣾⣿⣉⠀⠀⠀⠈⠙⣧⠀⠀
⠀⠀⣿⠀⠀⢀⣴⣿⣿⣿⣿⣿⣿⣿⣿⣿⣿⣿⣿⣿⣿⣿⣿⣦⡀⠀⠀⣿⠀⠀
⠀⠀⠹⣆⣴⣿⣿⣿⣿⣿⣿⣿⣿⣿⣿⣿⣿⣿⣿⣿⣿⣿⣿⣿⣿⣦⣰⠏⠀⠀
⠀⠀⠀⣽⣿⣿⣿⡿⠟⠋⠉⠙⢿⣿⣿⣿⣿⡿⠋⠉⠙⠻⢿⣿⣿⣿⣯⠀⠀⠀
⠀⠀⢰⣿⣿⡿⠋⠀⠀⠀⠀⠀⠈⣿⣿⣿⣿⠁⠀⠀⠀⠀⠀⠙⢿⣿⣿⡆⠀⠀
⠀⠀⣿⣿⣿⡇⠀⠀⠀⠀⢀⣄⠀⣿⣿⣿⣿⠀⣠⡀⠀⠀⠀⠀⢸⣿⣿⣿⠀⠀
⠀⠀⣿⣿⣿⣿⡀⠀⠀⠀⠈⠋⣼⣿⣿⣿⣿⣧⠙⠁⠀⠀⠀⢀⣿⣿⣿⣿⠀⠀
⠀⠀⢿⣿⣿⣿⣷⡀⠀⢀⣠⣾⣿⣿⣿⣿⣿⣿⣷⣄⡀⠀⢀⣾⣿⣿⣿⣿⠀⠀
⠀⠀⠘⣿⣿⣿⣿⣿⣿⣿⣿⣿⣿⣿⣿⣿⣿⣿⣿⣿⣿⣿⣿⣿⣿⣿⣿⠇⠀⠀
⠀⠀⠀⠘⠿⣿⣿⣿⣿⣿⣿⣿⣯⡀⠀⠀⢀⣽⣿⣿⣿⣿⣿⣿⣿⡿⠋⠀⠀⠀
⠀⠀⠀⠀⠀⠀⠉⠙⣿⣿⣿⣿⣿⣿⣦⣴⣿⣿⣿⣿⣿⣿⠋⠉⠁⠀⠀⠀⠀⠀
⠀⠀⠀⠀⠀⠀⠀⠀⠈⢿⣿⣇⡉⠻⠿⠿⠟⢉⣸⣿⡿⠁⠀⠀⠀⠀⠀⠀⠀⠀
⠀⠀⠀⠀⠀⠀⠀⠀⠀⠈⠛⠿⢿⣿⣶⣶⣿⡿⠿⠛⠁⠀⠀⠀⠀⠀⠀⠀⠀⠀
⠀⠀⠀⠀⠀⠀⠀⠀⠀⠀⠀⠀⠀⠀⠀⠀⠀⠀⠀⠀⠀⠀⠀⠀⠀⠀⠀⠀⠀⠀